50 50
2 9 2 9 2 9 2 9 2 9 2 9 2 9 2 9 2 9 2 9 2 9 2 9 2 9 2 9 2 9 2 9 2 9 2 9 2 9 2 9 2 9 2 9 2 9 2 9 2 9 2 9 2 9 2 9 2 9 2 9 2 9 2 9 2 9 2 9 2 9 2 9 2 9 2 9 2 9 2 9 2 9 2 9 2 9 2 9 2 9 2 9 2 9 2 9 2 9 2 9
2 9 2 5 2 5 2 5 2 5 2 5 2 5 0 3 0 3 0 3 2 5 2 5 2 5 2 5 2 5 2 5 2 5 2 5 2 5 2 5 2 5 2 5 2 5 2 5 2 5 2 5 2 5 2 5 2 5 2 5 2 5 2 5 2 5 2 5 2 5 2 5 2 5 2 5 2 5 2 5 2 5 2 5 2 5 2 5 2 5 2 5 2 5 2 5 2 5 2 9
2 9 2 5 2 5 2 5 2 5 2 5 2 5 0 3 0 3 0 3 2 5 2 5 2 5 2 5 2 5 2 5 2 5 2 5 2 5 2 5 2 5 2 5 2 5 2 5 2 5 2 5 2 5 2 5 2 5 2 5 2 5 2 5 2 5 2 5 2 5 2 5 2 5 2 5 2 5 2 5 2 5 2 5 2 5 2 5 2 5 2 5 2 5 2 5 2 5 2 9
2 9 2 5 2 5 2 5 2 5 2 5 2 5 0 3 0 3 0 3 2 5 2 5 2 5 2 5 2 5 2 5 2 5 2 5 2 5 2 5 2 5 2 5 2 5 2 5 2 5 2 5 2 5 2 5 2 5 2 6 2 6 2 6 2 6 2 6 2 6 2 5 2 5 2 5 2 5 2 5 2 5 2 5 2 5 2 5 2 5 2 5 2 5 2 5 2 5 2 9
2 9 2 5 2 5 2 5 2 5 2 5 2 5 0 3 0 3 0 3 2 5 2 5 2 5 2 5 2 5 2 5 2 5 2 5 2 5 2 5 2 5 2 5 2 5 2 5 2 5 2 5 2 5 2 5 2 5 2 6 2 6 2 6 2 6 2 6 2 6 2 5 2 5 2 6 2 6 2 5 2 5 2 5 2 5 2 5 2 5 2 5 2 5 2 5 2 5 2 9
2 9 2 5 2 5 2 5 2 5 2 5 2 5 0 3 0 3 0 3 2 5 2 5 2 5 2 5 2 5 2 5 2 5 2 5 2 5 2 5 2 5 2 5 2 5 2 5 2 5 2 5 2 5 2 5 2 5 2 6 2 6 2 6 2 6 2 6 2 6 2 6 2 6 2 6 2 6 2 5 2 5 2 5 2 5 2 5 2 5 2 5 2 5 2 5 2 5 2 9
2 9 2 5 2 5 2 5 2 5 2 5 2 5 0 3 0 3 0 3 2 5 2 5 2 5 2 5 2 5 2 5 2 5 2 5 2 5 2 5 2 5 2 5 2 5 2 5 2 5 2 5 2 5 2 5 2 5 2 6 2 6 2 6 2 6 2 6 2 6 2 6 2 6 2 6 2 6 2 5 2 5 2 5 1 5 2 5 2 5 2 5 2 5 2 5 2 5 2 9
2 9 2 5 2 5 2 5 2 5 2 5 2 5 0 3 0 3 0 3 2 5 3 5 3 5 3 5 3 5 2 5 2 5 2 5 3 5 3 5 3 5 2 5 2 5 2 5 3 5 3 5 2 5 2 5 2 5 2 6 2 6 2 6 2 6 1 6 1 6 1 6 2 6 2 6 2 6 1 5 2 5 2 5 1 5 2 5 2 5 1 5 1 5 2 5 1 5 2 9
2 9 4 5 4 5 4 5 4 6 4 6 4 6 4 6 4 6 4 6 4 6 4 6 4 6 3 5 3 5 3 5 3 5 3 5 3 5 3 5 3 5 3 5 3 5 3 5 3 5 3 5 3 5 3 5 2 5 1 6 2 6 2 6 2 6 1 6 2 6 1 6 2 6 2 6 1 6 1 5 1 5 2 5 1 5 2 5 2 5 1 5 2 5 2 5 1 5 2 9
2 9 4 5 4 5 4 5 4 6 4 6 4 6 4 6 4 6 4 6 4 6 4 6 4 6 4 6 4 6 4 5 4 5 4 5 4 5 4 5 4 5 4 5 4 5 4 5 4 5 4 5 4 5 4 5 4 5 4 6 4 6 4 6 4 6 4 6 4 6 4 6 4 6 4 6 4 6 4 5 4 5 4 5 4 6 4 6 4 5 4 5 4 5 4 5 4 5 2 9
2 9 2 5 2 5 2 5 2 5 2 5 4 6 4 6 4 6 4 6 4 6 4 6 4 6 4 6 4 6 4 5 4 5 4 5 4 5 4 5 4 5 4 5 4 5 4 5 4 5 4 5 4 5 4 5 4 5 4 6 4 6 4 6 4 6 4 6 4 6 4 6 4 6 4 6 4 6 4 5 4 5 4 5 4 6 4 6 4 5 4 5 4 5 4 5 4 5 2 9
2 9 2 5 2 5 2 5 2 5 2 5 4 6 4 6 4 6 4 6 4 6 4 6 4 6 3 5 2 5 2 5 1 5 1 5 2 5 2 5 1 5 2 5 2 5 1 5 1 5 2 5 2 5 2 5 2 5 1 6 1 6 2 6 1 6 1 6 2 6 2 6 4 6 4 6 4 6 4 5 4 5 4 5 4 6 4 6 4 5 4 5 4 5 4 5 4 5 2 9
2 9 2 5 2 5 2 5 2 5 2 5 2 5 2 5 3 5 0 3 0 3 0 3 0 3 0 3 3 5 2 5 2 5 2 5 2 5 2 5 2 5 2 5 2 5 2 5 1 5 1 5 2 5 2 5 2 5 1 6 1 6 2 6 1 6 2 6 4 6 4 6 4 6 4 6 4 6 4 5 4 5 4 5 4 6 4 6 4 5 4 5 4 5 4 5 4 5 2 9
2 9 2 5 2 5 2 5 2 5 2 5 2 5 2 5 3 5 3 5 0 3 0 3 0 3 0 3 3 5 3 5 2 5 2 5 2 5 2 5 2 5 2 5 2 5 2 5 1 5 2 5 2 5 2 5 2 5 2 5 2 5 2 5 4 5 4 5 4 6 4 6 4 6 4 6 4 6 4 5 4 5 4 5 2 6 1 6 1 5 2 5 1 5 2 5 1 5 2 9
2 9 2 5 2 5 2 5 2 5 2 5 2 5 2 5 3 5 3 5 0 3 0 3 0 3 0 3 0 3 3 5 2 5 2 5 2 5 2 5 2 5 2 5 2 5 2 5 2 5 2 5 2 5 1 5 2 5 2 5 4 5 4 5 4 5 4 5 4 6 4 6 4 6 4 6 4 6 4 5 2 5 2 5 2 6 1 6 1 5 2 5 2 5 2 5 2 5 2 9
2 9 2 5 2 5 2 5 2 5 2 5 2 5 2 5 2 5 3 5 0 3 0 3 0 3 0 3 0 3 3 5 3 5 2 5 2 5 2 5 2 5 2 5 2 5 2 5 2 5 2 5 2 5 1 5 4 5 4 5 4 5 4 5 4 5 4 5 1 5 4 6 2 6 2 6 4 6 4 6 2 6 2 6 2 6 2 6 1 5 2 5 2 5 2 5 2 5 2 9
2 9 2 5 2 5 2 5 2 5 2 5 2 5 2 5 2 5 3 5 3 5 0 3 0 3 0 3 0 3 0 3 3 5 2 5 2 5 2 5 2 5 2 5 2 5 2 5 2 5 1 5 1 5 4 5 4 5 4 5 4 5 4 5 1 5 1 5 1 5 2 5 2 6 2 6 4 6 4 6 2 6 2 6 2 6 2 6 2 5 2 5 3 5 3 5 2 5 2 9
2 9 2 5 2 5 2 5 2 5 2 5 2 5 2 5 2 5 2 5 3 5 0 3 0 3 0 3 0 3 0 3 3 5 3 5 2 5 2 5 2 5 2 5 2 5 2 5 2 5 1 5 1 5 4 5 4 5 4 5 4 5 2 5 1 5 1 5 1 5 2 5 2 5 2 5 4 5 4 6 1 6 1 6 2 6 2 6 2 5 3 5 3 5 3 5 2 5 2 9
2 9 2 5 2 5 2 5 2 5 2 5 2 5 2 5 2 5 2 5 3 5 3 5 0 3 0 3 0 3 0 3 0 3 3 5 2 5 2 5 2 5 2 5 2 5 2 5 2 5 1 5 4 5 4 5 4 5 4 5 2 5 2 5 2 5 2 5 2 5 2 5 1 5 1 5 4 5 4 6 1 6 1 6 3 6 3 6 3 6 2 5 2 5 2 5 2 5 2 9
2 9 2 5 2 5 2 5 2 5 2 5 2 5 2 5 2 5 2 5 2 5 3 5 0 3 0 3 0 3 0 3 0 3 3 5 3 5 2 5 2 5 2 5 1 5 1 5 4 5 4 5 4 5 4 5 4 5 1 5 2 5 2 5 2 5 2 5 2 5 2 5 1 5 1 5 4 6 4 6 1 6 1 6 3 6 3 5 3 6 3 5 2 5 2 5 2 5 2 9
2 9 2 5 2 5 2 5 2 5 2 5 2 5 2 5 2 5 2 5 2 5 3 5 0 3 0 3 0 3 0 3 0 3 0 3 3 5 2 5 2 5 2 5 1 5 1 5 4 5 4 5 4 5 4 5 4 5 1 5 2 5 2 5 2 5 2 5 2 5 2 5 2 5 1 5 4 6 4 6 1 6 2 6 2 6 3 5 3 6 3 5 3 5 3 5 2 5 2 9
2 9 2 5 2 5 2 5 2 5 2 5 2 5 2 5 2 5 2 5 2 5 3 5 3 5 0 3 0 3 0 3 0 3 0 3 3 5 2 5 2 5 1 5 4 5 4 5 4 5 4 5 4 5 1 5 1 5 1 5 2 5 2 5 2 5 2 5 2 5 2 5 2 5 1 5 4 6 4 6 2 6 2 6 3 6 3 5 3 6 3 5 3 5 3 5 2 5 2 9
2 9 2 5 2 5 2 5 2 5 2 5 2 5 2 5 2 5 2 5 2 5 2 5 3 5 3 5 0 3 0 3 0 3 0 3 3 5 3 5 1 5 4 5 4 5 4 5 4 5 1 5 1 5 2 5 2 5 2 5 2 5 2 5 2 5 2 5 2 5 2 5 2 5 2 5 4 5 4 5 2 6 3 6 2 6 2 5 2 6 2 5 2 5 3 5 2 5 2 9
2 9 2 5 2 5 2 5 2 5 2 5 2 5 2 5 2 5 2 5 2 5 2 5 2 5 3 5 0 3 0 3 0 3 0 3 0 3 3 5 4 6 4 5 4 5 4 5 1 5 1 5 1 5 2 5 2 5 2 5 2 5 2 5 2 5 2 5 2 5 2 5 2 5 2 5 4 5 4 5 2 5 2 6 2 6 3 5 3 6 2 5 3 5 3 5 2 5 2 9
2 9 2 5 2 5 2 5 2 5 2 5 2 5 2 5 2 5 2 5 2 5 2 5 2 5 3 5 0 3 0 3 0 3 0 3 0 3 4 6 4 6 4 6 4 5 4 5 1 5 1 5 2 5 2 5 2 5 2 5 2 5 2 5 2 5 2 5 2 5 2 5 2 5 2 5 4 5 4 5 1 5 2 5 2 6 2 6 2 6 3 5 3 5 2 5 2 5 2 9
2 9 2 5 2 5 2 5 2 5 2 5 2 5 2 5 2 5 2 5 2 5 2 5 2 5 3 5 3 5 0 3 0 3 0 3 4 6 4 6 4 6 4 6 4 6 4 5 1 5 2 5 2 5 2 5 2 5 2 5 2 5 2 5 2 5 2 5 2 5 2 5 2 5 1 5 4 5 4 5 1 5 1 5 2 5 2 6 3 6 3 5 3 5 2 5 2 5 2 9
2 9 2 5 2 5 2 5 2 5 2 5 2 5 2 5 2 5 2 5 2 5 2 5 2 5 2 5 3 5 0 3 0 3 4 6 4 6 4 6 4 6 4 6 4 6 2 5 2 5 2 5 2 5 2 5 2 5 2 5 2 5 2 5 2 5 2 5 2 5 2 5 1 5 1 5 4 5 4 5 1 5 3 5 3 5 3 5 3 5 3 5 2 5 2 5 2 5 2 9
2 9 2 5 2 5 2 5 2 5 2 5 2 5 2 5 2 5 2 5 2 5 2 5 2 5 2 5 3 5 0 3 4 6 4 6 4 6 4 6 4 6 4 6 2 5 2 5 2 5 2 5 2 5 2 5 2 5 2 5 2 5 2 5 2 5 2 5 2 5 2 5 2 5 2 5 4 5 4 5 1 5 3 5 3 5 2 5 2 5 2 5 2 5 2 5 2 5 2 9
2 9 2 5 2 5 2 5 2 5 2 5 2 5 2 5 2 5 2 5 2 5 2 5 2 5 2 5 3 5 4 6 4 6 4 6 4 6 4 6 4 6 2 5 2 5 2 5 2 5 2 5 2 5 2 5 2 5 2 5 2 5 2 5 2 5 2 5 2 5 2 5 2 5 2 5 4 5 4 5 1 5 2 5 2 5 2 5 2 5 2 5 2 5 2 5 2 5 2 9
2 9 2 5 2 5 2 5 2 5 2 5 2 5 2 5 2 5 2 5 2 5 2 5 2 5 2 5 4 6 4 6 4 6 4 6 4 6 4 6 0 3 2 5 2 5 2 5 2 5 2 5 2 5 2 5 2 5 2 5 2 5 2 5 2 5 2 5 2 5 2 5 1 5 1 5 4 5 4 5 2 5 2 5 2 5 2 5 2 5 2 5 2 5 2 5 2 5 2 9
2 9 2 5 2 5 2 5 2 5 2 5 2 5 2 5 2 5 2 5 2 5 1 5 1 5 4 5 4 6 4 6 4 6 4 6 4 6 0 3 0 3 0 3 2 5 2 5 2 5 2 5 2 5 2 5 2 5 2 5 2 5 2 5 2 5 2 5 2 5 2 5 1 5 1 5 4 5 4 5 2 5 2 5 2 5 2 5 2 5 2 5 2 5 2 5 2 5 2 9
2 9 2 5 2 5 2 5 2 5 2 5 2 5 2 5 2 5 2 5 2 5 1 5 4 5 4 5 4 6 4 6 4 6 4 6 0 3 0 3 0 3 0 3 0 3 0 3 0 3 2 5 2 5 2 5 2 5 2 5 2 5 2 5 2 5 2 5 2 5 2 5 2 5 2 5 4 6 4 6 2 5 2 5 2 5 2 5 2 5 2 5 2 5 2 5 2 5 2 9
2 9 2 5 2 5 2 5 2 5 2 5 2 5 2 5 2 5 2 5 2 5 4 5 4 5 4 5 4 5 4 6 4 6 2 5 0 3 0 3 0 3 0 3 0 3 0 3 0 3 0 3 0 3 0 3 0 3 0 3 0 3 0 3 0 3 0 3 0 3 0 3 0 3 0 3 4 6 4 6 0 3 0 3 0 3 0 3 0 3 0 3 0 3 0 3 0 3 2 9
2 9 2 5 2 5 2 5 2 5 2 5 1 5 1 5 2 5 2 5 4 5 4 5 4 5 4 5 4 5 4 6 2 5 2 5 2 5 0 3 0 3 0 3 0 3 0 3 0 3 0 3 0 3 0 3 0 3 0 3 0 3 0 3 0 3 0 3 0 3 0 3 0 3 0 3 4 6 4 6 0 3 0 3 0 3 0 3 0 3 0 3 0 3 0 3 0 3 2 9
2 9 2 5 2 5 2 5 2 5 2 5 2 5 1 5 1 5 4 5 4 5 4 5 4 5 4 5 2 5 2 5 2 5 2 5 2 5 2 5 0 3 0 3 0 3 0 3 0 3 0 3 0 3 0 3 0 3 0 3 0 3 0 3 0 3 0 3 0 3 0 3 0 3 0 3 4 6 4 6 0 3 0 3 0 3 0 3 0 3 0 3 0 3 0 3 0 3 2 9
2 9 2 5 2 5 2 5 2 5 2 5 2 5 1 5 4 5 4 5 4 5 4 5 2 5 2 5 2 5 2 5 2 5 2 5 2 5 2 5 2 5 0 3 0 3 0 3 0 3 0 3 0 3 0 3 0 3 0 3 0 3 0 3 0 3 0 3 0 3 0 3 0 3 0 3 4 6 4 6 0 3 0 3 0 3 0 3 0 3 0 3 0 3 0 3 0 3 2 9
2 9 2 5 2 5 2 5 2 5 1 5 1 5 4 5 4 5 4 5 4 5 2 5 2 5 2 5 2 5 2 5 2 5 2 5 3 5 2 5 2 5 2 5 3 5 2 5 2 5 2 5 2 5 2 5 2 5 2 5 2 5 2 5 2 5 2 5 2 5 2 5 2 5 2 5 4 6 4 6 0 3 0 3 0 3 0 3 0 3 0 3 0 3 0 3 0 3 2 9
2 9 2 5 2 5 2 5 2 6 1 5 4 5 4 5 4 5 4 5 2 5 2 5 2 5 2 5 2 5 2 5 2 5 2 5 3 5 2 5 3 5 3 5 3 5 3 5 2 5 2 5 2 5 2 5 2 5 2 5 2 5 2 5 2 5 2 5 2 5 2 5 2 5 2 5 4 6 4 6 0 3 0 3 0 3 0 3 0 3 0 3 2 5 2 5 2 5 2 9
2 9 2 6 2 6 2 6 2 6 4 5 4 5 4 5 4 5 2 5 2 5 2 5 2 5 2 5 2 5 3 5 3 5 2 5 3 5 3 5 3 5 3 5 3 5 3 5 2 5 2 5 2 5 2 5 2 5 2 5 2 5 2 5 2 5 2 5 2 5 2 5 2 5 1 5 4 6 4 6 2 5 0 3 0 3 0 3 0 3 0 3 2 5 2 5 2 5 2 9
2 9 2 6 1 6 1 6 4 6 4 5 4 5 4 5 2 5 2 5 2 5 2 5 2 5 2 5 2 5 3 5 3 5 2 5 2 5 3 5 3 5 3 5 3 5 3 5 2 5 2 5 2 5 2 5 2 5 2 5 2 5 2 5 2 5 2 5 2 5 2 5 1 5 1 5 4 6 4 6 2 5 2 5 0 3 0 3 0 3 0 3 0 3 0 3 2 5 2 9
2 9 2 6 1 6 4 6 4 6 4 6 4 5 2 5 2 5 2 5 2 5 2 5 2 5 2 5 2 5 2 5 3 5 2 5 2 5 3 5 3 5 3 5 2 5 2 5 2 5 2 5 2 5 2 5 2 5 2 5 2 5 2 5 2 5 2 5 2 5 2 5 2 5 1 5 4 5 4 5 2 5 2 5 0 3 0 3 0 3 0 3 0 3 0 3 0 3 2 9
2 9 2 6 4 6 4 6 4 6 4 6 2 5 2 5 2 5 2 5 2 5 2 5 2 5 2 5 3 5 3 5 3 5 2 5 2 5 3 5 3 5 2 5 2 5 2 5 2 5 2 5 2 5 2 5 2 5 2 5 2 5 2 5 2 5 2 5 2 5 2 5 1 5 1 5 4 5 4 5 2 5 2 5 2 5 0 3 0 3 0 3 0 3 0 3 0 3 2 9
2 9 4 6 4 6 4 6 4 6 2 6 2 5 2 5 2 5 2 5 2 5 2 5 2 5 2 5 3 5 3 5 2 5 2 5 2 5 2 5 2 5 2 5 2 5 2 5 2 5 2 5 2 5 2 5 2 5 2 5 2 5 3 5 3 5 2 5 2 5 2 5 2 5 2 5 4 5 4 5 2 5 2 5 2 5 2 3 2 3 0 3 0 3 0 3 0 3 2 9
2 9 4 6 4 6 4 6 2 6 2 6 2 5 2 5 2 5 2 5 3 5 2 5 2 5 3 5 3 5 3 5 2 5 2 5 2 5 2 5 2 5 2 5 2 5 2 5 2 5 2 5 2 5 2 5 2 5 2 5 2 5 2 5 3 5 2 5 2 5 2 5 2 5 2 5 4 5 4 5 2 5 2 5 2 5 2 5 2 5 2 3 0 3 0 3 0 3 2 9
2 9 4 6 4 6 1 6 2 6 2 6 2 5 2 5 2 5 2 5 3 5 3 5 3 5 3 5 2 5 3 5 3 5 2 5 2 5 2 5 2 5 2 5 2 5 2 5 2 5 2 5 2 5 2 5 2 5 3 5 3 5 3 5 3 5 2 5 2 5 2 5 2 5 2 5 4 5 4 5 2 5 2 5 2 5 2 5 2 5 2 5 2 5 2 5 0 3 2 9
2 9 4 6 1 6 1 6 2 6 2 6 2 5 2 5 2 5 2 5 3 5 3 5 3 5 3 5 2 5 2 5 3 5 2 5 2 5 2 5 2 5 2 5 2 5 2 5 2 5 2 5 2 5 2 5 3 5 3 5 2 5 3 5 3 5 2 5 2 5 2 5 1 5 1 5 4 5 4 5 1 5 2 5 2 5 2 5 2 5 2 5 2 5 2 5 2 5 2 9
2 9 2 6 1 6 1 6 2 6 2 5 2 5 2 5 2 5 2 5 2 5 2 5 3 5 3 5 2 5 2 5 3 5 2 5 2 5 2 5 2 5 2 5 2 5 2 5 2 5 2 5 2 5 2 5 3 5 3 5 3 5 3 5 3 5 2 5 2 5 2 5 1 5 1 5 4 5 4 5 1 5 1 5 2 5 2 5 2 5 2 5 2 5 2 5 2 5 2 9
2 9 2 6 2 6 2 6 2 5 2 5 2 5 2 5 2 5 2 5 2 5 2 5 3 5 3 5 2 5 2 5 2 5 2 5 2 5 2 5 2 5 2 5 2 5 2 5 2 5 2 5 2 5 2 5 3 5 3 5 3 5 3 5 2 5 2 5 2 5 2 5 2 5 1 5 4 5 4 5 1 5 2 5 2 5 2 5 2 5 2 5 2 5 2 5 2 5 2 9
2 9 2 5 2 5 2 5 2 5 2 5 2 5 2 5 2 5 2 5 2 5 2 5 2 5 2 5 2 5 2 5 2 5 2 5 2 5 2 5 2 5 2 5 2 5 2 5 2 5 2 5 2 5 2 5 2 5 2 5 2 5 3 5 2 5 2 5 2 5 2 5 2 5 2 5 4 5 4 5 2 5 2 5 2 5 2 5 2 5 2 5 2 5 2 5 2 5 2 9
2 9 2 9 2 9 2 9 2 9 2 9 2 9 2 9 2 9 2 9 2 9 2 9 2 9 2 9 2 9 2 9 2 9 2 9 2 9 2 9 2 9 2 9 2 9 2 9 2 9 2 9 2 9 2 9 2 9 2 9 2 9 2 9 2 9 2 9 2 9 2 9 2 9 2 9 4 9 4 9 2 9 2 9 2 9 2 9 2 9 2 9 2 9 2 9 2 9 2 9
