50 50
2 5 2 5 2 5 2 5 2 5 2 5 2 5 0 3 0 3 0 3 2 5 2 5 2 5 2 5 2 5 2 5 2 5 2 5 2 5 2 5 2 5 2 5 2 5 2 5 2 5 2 5 2 5 2 5 2 5 2 5 2 5 2 5 2 5 2 5 2 5 2 5 2 5 2 5 2 5 2 5 2 5 2 5 2 5 2 5 2 5 2 5 2 5 2 5 2 5 2 5
2 5 2 5 2 5 2 5 2 5 2 5 2 5 0 3 0 3 0 3 2 5 2 5 2 5 2 5 2 5 2 5 2 5 2 5 2 5 2 5 2 5 2 5 2 5 2 5 2 5 2 5 2 5 2 5 2 5 2 5 2 5 2 5 2 5 2 5 2 5 2 5 2 5 2 5 2 5 2 5 2 5 2 5 2 5 2 5 2 5 2 5 2 5 2 5 2 5 2 5
2 5 2 5 2 5 2 5 2 5 2 5 2 5 0 3 0 3 0 3 2 5 2 5 2 5 2 5 2 5 2 5 2 5 2 5 2 5 2 5 2 5 2 5 2 5 2 5 2 5 2 5 2 5 2 5 2 5 2 5 2 5 2 5 2 5 2 5 2 5 2 5 2 5 2 5 2 5 2 5 2 5 2 5 2 5 2 5 2 5 2 5 2 5 2 5 2 5 2 5
2 5 2 5 2 5 2 5 2 5 2 5 2 5 0 3 0 3 0 3 2 5 2 5 2 5 2 5 2 5 2 5 2 5 2 5 2 5 2 5 2 5 2 5 2 5 2 5 2 5 2 5 2 5 2 5 2 5 2 5 2 5 2 5 2 5 2 5 2 5 2 5 2 5 2 5 2 5 2 5 2 5 2 5 2 5 2 5 2 5 2 5 2 5 2 5 2 5 2 5
2 5 2 5 2 5 2 5 2 5 2 5 2 5 0 3 0 3 0 3 2 5 2 5 2 5 2 5 2 5 2 5 2 5 2 5 2 5 2 5 2 5 2 5 2 5 2 5 2 5 2 5 2 5 2 5 2 5 2 5 2 5 2 5 2 5 2 5 2 5 2 5 2 5 2 5 2 5 2 5 2 5 2 5 2 5 2 5 2 5 2 5 2 5 2 5 2 5 2 5
2 5 2 5 2 5 2 5 2 5 2 5 2 5 0 3 0 3 0 3 2 5 2 5 2 5 2 5 2 5 2 5 2 5 2 5 2 5 2 5 2 5 2 5 2 5 2 5 2 5 2 5 2 5 2 5 2 5 2 5 2 5 2 5 2 5 2 5 2 5 2 5 2 5 2 5 2 5 2 5 2 5 2 5 2 5 2 5 2 5 2 5 2 5 2 5 2 5 2 5
2 5 2 5 2 5 2 5 2 5 2 5 2 5 0 3 0 3 0 3 2 5 2 5 2 5 2 5 2 5 2 5 2 5 2 5 2 5 2 5 2 5 2 5 2 5 2 5 2 5 2 5 2 5 2 5 2 5 2 5 2 5 2 5 2 5 2 5 2 5 2 5 2 5 2 5 2 5 2 5 2 5 2 5 1 5 2 5 2 5 2 5 2 5 2 5 2 5 2 5
2 5 2 5 2 5 2 5 2 5 2 5 2 5 0 3 0 3 0 3 2 5 3 5 3 5 3 5 3 5 2 5 2 5 2 5 3 5 3 5 3 5 2 5 2 5 2 5 3 5 3 5 2 5 2 5 2 5 2 5 2 5 2 5 2 5 1 5 1 5 1 5 2 5 2 5 2 5 1 5 2 5 2 5 1 5 2 5 2 5 1 5 1 5 2 5 1 5 2 5
4 5 4 5 4 5 4 5 4 6 4 6 4 6 4 6 4 6 4 6 4 6 4 6 4 6 3 5 3 5 3 5 3 5 3 5 3 5 3 5 3 5 3 5 3 5 3 5 3 5 3 5 3 5 3 5 2 5 1 5 2 5 2 5 2 5 1 5 2 5 1 5 2 5 2 5 1 5 1 5 1 5 2 5 1 5 2 5 2 5 1 5 2 5 2 5 1 5 2 5
4 5 4 5 4 5 4 5 4 6 4 6 4 6 4 6 4 6 4 6 4 6 4 6 4 6 4 6 4 6 4 5 4 5 4 5 4 5 4 5 4 5 4 5 4 5 4 5 4 5 4 5 4 5 4 5 4 5 4 5 4 5 4 5 4 5 4 5 4 5 4 5 4 5 4 5 4 5 4 5 4 5 4 5 4 5 4 5 4 5 4 5 4 5 4 5 4 5 4 5
2 5 2 5 2 5 2 5 2 5 2 5 4 6 4 6 4 6 4 6 4 6 4 6 4 6 4 6 4 6 4 5 4 5 4 5 4 5 4 5 4 5 4 5 4 5 4 5 4 5 4 5 4 5 4 5 4 5 4 5 4 5 4 5 4 5 4 5 4 5 4 5 4 5 4 5 4 5 4 5 4 5 4 5 4 5 4 5 4 5 4 5 4 5 4 5 4 5 4 5
2 5 2 5 2 5 2 5 2 5 2 5 4 6 4 6 4 6 4 6 4 6 4 6 4 6 3 5 2 5 2 5 1 5 1 5 2 5 2 5 1 5 2 5 2 5 1 5 1 5 2 5 2 5 2 5 2 5 1 5 1 5 2 5 1 5 1 5 2 5 2 5 4 5 4 5 4 5 4 5 4 5 4 5 4 5 4 5 4 5 4 5 4 5 4 5 4 5 4 5
2 5 2 5 2 5 2 5 2 5 2 5 2 5 2 5 3 5 0 3 0 3 0 3 0 3 0 3 3 5 2 5 2 5 2 5 2 5 2 5 2 5 2 5 2 5 2 5 1 5 1 5 2 5 2 5 2 5 1 5 1 5 2 5 1 5 2 5 4 5 4 5 4 5 4 5 4 5 4 5 4 5 4 5 4 5 4 5 4 5 4 5 4 5 4 5 4 5 4 5
2 5 2 5 2 5 2 5 2 5 2 5 2 5 2 5 3 5 3 5 0 3 0 3 0 3 0 3 3 5 3 5 2 5 2 5 2 5 2 5 2 5 2 5 2 5 2 5 1 5 2 5 2 5 2 5 2 5 2 5 2 5 2 5 4 5 4 5 4 5 4 5 4 5 4 5 4 5 4 5 4 5 4 5 2 5 1 5 1 5 2 5 1 5 2 5 1 5 1 5
2 5 2 5 2 5 2 5 2 5 2 5 2 5 2 5 3 5 3 5 0 3 0 3 0 3 0 3 0 3 3 5 2 5 2 5 2 5 2 5 2 5 2 5 2 5 2 5 2 5 2 5 2 5 1 5 2 5 2 5 4 5 4 5 4 5 4 5 4 5 4 5 4 5 4 5 4 5 4 5 2 5 2 5 2 5 1 5 1 5 2 5 2 5 2 5 2 5 2 5
2 5 2 5 2 5 2 5 2 5 2 5 2 5 2 5 2 5 3 5 0 3 0 3 0 3 0 3 0 3 3 5 3 5 2 5 2 5 2 5 2 5 2 5 2 5 2 5 2 5 2 5 2 5 1 5 4 5 4 5 4 5 4 5 4 5 4 5 1 5 4 5 2 5 2 5 4 5 4 5 2 5 2 5 2 5 2 5 1 5 2 5 2 5 2 5 2 5 2 5
2 5 2 5 2 5 2 5 2 5 2 5 2 5 2 5 2 5 3 5 3 5 0 3 0 3 0 3 0 3 0 3 3 5 2 5 2 5 2 5 2 5 2 5 2 5 2 5 2 5 1 5 1 5 4 5 4 5 4 5 4 5 4 5 1 5 1 5 1 5 2 5 2 5 2 5 4 5 4 5 2 5 2 5 2 5 2 5 2 5 2 5 3 5 3 5 2 5 2 5
2 5 2 5 2 5 2 5 2 5 2 5 2 5 2 5 2 5 2 5 3 5 0 3 0 3 0 3 0 3 0 3 3 5 3 5 2 5 2 5 2 5 2 5 2 5 2 5 2 5 1 5 1 5 4 5 4 5 4 5 4 5 2 5 1 5 1 5 1 5 2 5 2 5 2 5 4 5 4 5 1 5 1 5 2 5 2 5 2 5 3 5 3 5 3 5 2 5 2 5
2 5 2 5 2 5 2 5 2 5 2 5 2 5 2 5 2 5 2 5 3 5 3 5 0 3 0 3 0 3 0 3 0 3 3 5 2 5 2 5 2 5 2 5 2 5 2 5 2 5 1 5 4 5 4 5 4 5 4 5 2 5 2 5 2 5 2 5 2 5 2 5 1 5 1 5 4 5 4 5 1 5 1 5 3 5 3 5 3 5 2 5 2 5 2 5 2 5 2 5
2 5 2 5 2 5 2 5 2 5 2 5 2 5 2 5 2 5 2 5 2 5 3 5 0 3 0 3 0 3 0 3 0 3 3 5 3 5 2 5 2 5 2 5 1 5 1 5 4 5 4 5 4 5 4 5 4 5 1 5 2 5 2 5 2 5 2 5 2 5 2 5 1 5 1 5 4 5 4 5 1 5 1 5 3 5 3 5 3 5 3 5 2 5 2 5 2 5 2 5
2 5 2 5 2 5 2 5 2 5 2 5 2 5 2 5 2 5 2 5 2 5 3 5 0 3 0 3 0 3 0 3 0 3 0 3 3 5 2 5 2 5 2 5 1 5 1 5 4 5 4 5 4 5 4 5 4 5 1 5 2 5 2 5 2 5 2 5 2 5 2 5 2 5 1 5 4 5 4 5 1 5 2 5 2 5 3 5 3 5 3 5 3 5 3 5 2 5 2 5
2 5 2 5 2 5 2 5 2 5 2 5 2 5 2 5 2 5 2 5 2 5 3 5 3 5 0 3 0 3 0 3 0 3 0 3 3 5 2 5 2 5 1 5 4 5 4 5 4 5 4 5 4 5 1 5 1 5 1 5 2 5 2 5 2 5 2 5 2 5 2 5 2 5 1 5 4 5 4 5 2 5 2 5 3 5 3 5 3 5 3 5 3 5 3 5 2 5 2 5
2 5 2 5 2 5 2 5 2 5 2 5 2 5 2 5 2 5 2 5 2 5 2 5 3 5 3 5 0 3 0 3 0 3 0 3 3 5 3 5 1 5 4 5 4 5 4 5 4 5 1 5 1 5 2 5 2 5 2 5 2 5 2 5 2 5 2 5 2 5 2 5 2 5 2 5 4 5 4 5 2 5 3 5 2 5 2 5 2 5 2 5 2 5 3 5 2 5 2 5
2 5 2 5 2 5 2 5 2 5 2 5 2 5 2 5 2 5 2 5 2 5 2 5 2 5 3 5 0 3 0 3 0 3 0 3 0 3 3 5 4 6 4 5 4 5 4 5 1 5 1 5 1 5 2 5 2 5 2 5 2 5 2 5 2 5 2 5 2 5 2 5 2 5 2 5 4 5 4 5 2 5 2 5 2 5 3 5 3 5 2 5 3 5 3 5 2 5 2 5
2 5 2 5 2 5 2 5 2 5 2 5 2 5 2 5 2 5 2 5 2 5 2 5 2 5 3 5 0 3 0 3 0 3 0 3 0 3 4 6 4 6 4 6 4 5 4 5 1 5 1 5 2 5 2 5 2 5 2 5 2 5 2 5 2 5 2 5 2 5 2 5 2 5 2 5 4 5 4 5 1 5 2 5 2 5 2 5 2 5 3 5 3 5 2 5 2 5 2 5
2 5 2 5 2 5 2 5 2 5 2 5 2 5 2 5 2 5 2 5 2 5 2 5 2 5 3 5 3 5 0 3 0 3 0 3 4 6 4 6 4 6 4 6 4 6 4 5 1 5 2 5 2 5 2 5 2 5 2 5 2 5 2 5 2 5 2 5 2 5 2 5 2 5 1 5 4 5 4 5 1 5 1 5 2 5 2 5 3 5 3 5 3 5 2 5 2 5 2 5
2 5 2 5 2 5 2 5 2 5 2 5 2 5 2 5 2 5 2 5 2 5 2 5 2 5 2 5 3 5 0 3 0 3 4 6 4 6 4 6 4 6 4 6 4 6 2 5 2 5 2 5 2 5 2 5 2 5 2 5 2 5 2 5 2 5 2 5 2 5 2 5 1 5 1 5 4 5 4 5 1 5 3 5 3 5 3 5 3 5 3 5 2 5 2 5 2 5 2 5
2 5 2 5 2 5 2 5 2 5 2 5 2 5 2 5 2 5 2 5 2 5 2 5 2 5 2 5 3 5 0 3 4 6 4 6 4 6 4 6 4 6 4 6 2 5 2 5 2 5 2 5 2 5 2 5 2 5 2 5 2 5 2 5 2 5 2 5 2 5 2 5 2 5 2 5 4 5 4 5 1 5 3 5 3 5 2 5 2 5 2 5 2 5 2 5 2 5 2 5
2 5 2 5 2 5 2 5 2 5 2 5 2 5 2 5 2 5 2 5 2 5 2 5 2 5 2 5 3 5 4 6 4 6 4 6 4 6 4 6 4 6 2 5 2 5 2 5 2 5 2 5 2 5 2 5 2 5 2 5 2 5 2 5 2 5 2 5 2 5 2 5 2 5 2 5 4 5 4 5 1 5 2 5 2 5 2 5 2 5 2 5 2 5 2 5 2 5 2 5
2 5 2 5 2 5 2 5 2 5 2 5 2 5 2 5 2 5 2 5 2 5 2 5 2 5 2 5 4 6 4 6 4 6 4 6 4 6 4 6 0 3 2 5 2 5 2 5 2 5 2 5 2 5 2 5 2 5 2 5 2 5 2 5 2 5 2 5 2 5 2 5 1 5 1 5 4 5 4 5 2 5 2 5 2 5 2 5 2 5 2 5 2 5 2 5 2 5 2 5
2 5 2 5 2 5 2 5 2 5 2 5 2 5 2 5 2 5 2 5 2 5 1 5 1 5 4 5 4 6 4 6 4 6 4 6 4 6 0 3 0 3 0 3 2 5 2 5 2 5 2 5 2 5 2 5 2 5 2 5 2 5 2 5 2 5 2 5 2 5 2 5 1 5 1 5 4 5 4 5 2 5 2 5 2 5 2 5 2 5 2 5 2 5 2 5 2 5 2 5
2 5 2 5 2 5 2 5 2 5 2 5 2 5 2 5 2 5 2 5 2 5 1 5 4 5 4 5 4 6 4 6 4 6 4 6 0 3 0 3 0 3 0 3 0 3 0 3 0 3 2 5 2 5 2 5 2 5 2 5 2 5 2 5 2 5 2 5 2 5 2 5 2 5 2 5 4 6 4 6 2 5 2 5 2 5 2 5 2 5 2 5 2 5 2 5 2 5 2 5
2 5 2 5 2 5 2 5 2 5 2 5 2 5 2 5 2 5 2 5 2 5 4 5 4 5 4 5 4 5 4 6 4 6 2 5 0 3 0 3 0 3 0 3 0 3 0 3 0 3 0 3 0 3 0 3 0 3 0 3 0 3 0 3 0 3 0 3 0 3 0 3 0 3 0 3 4 6 4 6 0 3 0 3 0 3 0 3 0 3 0 3 0 3 0 3 0 3 0 3
2 5 2 5 2 5 2 5 2 5 2 5 1 5 1 5 2 5 2 5 4 5 4 5 4 5 4 5 4 5 4 6 2 5 2 5 2 5 0 3 0 3 0 3 0 3 0 3 0 3 0 3 0 3 0 3 0 3 0 3 0 3 0 3 0 3 0 3 0 3 0 3 0 3 0 3 4 6 4 6 0 3 0 3 0 3 0 3 0 3 0 3 0 3 0 3 0 3 0 3
2 5 2 5 2 5 2 5 2 5 2 5 2 5 1 5 1 5 4 5 4 5 4 5 4 5 4 5 2 5 2 5 2 5 2 5 2 5 2 5 0 3 0 3 0 3 0 3 0 3 0 3 0 3 0 3 0 3 0 3 0 3 0 3 0 3 0 3 0 3 0 3 0 3 0 3 4 6 4 6 0 3 0 3 0 3 0 3 0 3 0 3 0 3 0 3 0 3 0 3
2 5 2 5 2 5 2 5 2 5 2 5 2 5 1 5 4 5 4 5 4 5 4 5 2 5 2 5 2 5 2 5 2 5 2 5 2 5 2 5 2 5 0 3 0 3 0 3 0 3 0 3 0 3 0 3 0 3 0 3 0 3 0 3 0 3 0 3 0 3 0 3 0 3 0 3 4 6 4 6 0 3 0 3 0 3 0 3 0 3 0 3 0 3 0 3 0 3 0 3
2 5 2 5 2 5 2 5 2 5 1 5 1 5 4 5 4 5 4 5 4 5 2 5 2 5 2 5 2 5 2 5 2 5 2 5 3 5 2 5 2 5 2 5 3 5 2 5 2 5 2 5 2 5 2 5 2 5 2 5 2 5 2 5 2 5 2 5 2 5 2 5 2 5 2 5 4 6 4 6 0 3 0 3 0 3 0 3 0 3 0 3 0 3 0 3 0 3 0 3
2 5 2 5 2 5 2 5 2 5 1 5 4 5 4 5 4 5 4 5 2 5 2 5 2 5 2 5 2 5 2 5 2 5 2 5 3 5 2 5 3 5 3 5 3 5 3 5 2 5 2 5 2 5 2 5 2 5 2 5 2 5 2 5 2 5 2 5 2 5 2 5 2 5 2 5 4 6 4 6 0 3 0 3 0 3 0 3 0 3 0 3 2 5 2 5 2 5 2 5
2 5 2 5 2 5 2 5 2 5 4 5 4 5 4 5 4 5 2 5 2 5 2 5 2 5 2 5 2 5 3 5 3 5 2 5 3 5 3 5 3 5 3 5 3 5 3 5 2 5 2 5 2 5 2 5 2 5 2 5 2 5 2 5 2 5 2 5 2 5 2 5 2 5 1 5 4 6 4 6 2 5 0 3 0 3 0 3 0 3 0 3 2 5 2 5 2 5 2 5
2 5 2 5 1 5 1 5 4 5 4 5 4 5 4 5 2 5 2 5 2 5 2 5 2 5 2 5 2 5 3 5 3 5 2 5 2 5 3 5 3 5 3 5 3 5 3 5 2 5 2 5 2 5 2 5 2 5 2 5 2 5 2 5 2 5 2 5 2 5 2 5 1 5 1 5 4 6 4 6 2 5 2 5 0 3 0 3 0 3 0 3 0 3 0 3 2 5 2 5
2 5 2 5 1 5 4 5 4 5 4 5 4 5 2 5 2 5 2 5 2 5 2 5 2 5 2 5 2 5 2 5 3 5 2 5 2 5 3 5 3 5 3 5 2 5 2 5 2 5 2 5 2 5 2 5 2 5 2 5 2 5 2 5 2 5 2 5 2 5 2 5 2 5 1 5 4 5 4 5 2 5 2 5 0 3 0 3 0 3 0 3 0 3 0 3 0 3 2 5
2 5 2 5 4 5 4 5 4 5 4 5 2 5 2 5 2 5 2 5 2 5 2 5 2 5 2 5 3 5 3 5 3 5 2 5 2 5 3 5 3 5 2 5 2 5 2 5 2 5 2 5 2 5 2 5 2 5 2 5 2 5 2 5 2 5 2 5 2 5 2 5 1 5 1 5 4 5 4 5 2 5 2 5 2 5 0 3 0 3 0 3 0 3 0 3 0 3 0 3
2 5 4 5 4 5 4 5 4 5 2 5 2 5 2 5 2 5 2 5 2 5 2 5 2 5 2 5 3 5 3 5 2 5 2 5 2 5 2 5 2 5 2 5 2 5 2 5 2 5 2 5 2 5 2 5 2 5 2 5 2 5 3 5 3 5 2 5 2 5 2 5 2 5 2 5 4 5 4 5 2 5 2 5 2 5 2 3 2 3 0 3 0 3 0 3 0 3 0 3
4 5 4 5 4 5 4 5 2 5 2 5 2 5 2 5 2 5 2 5 3 5 2 5 2 5 3 5 3 5 3 5 2 5 2 5 2 5 2 5 2 5 2 5 2 5 2 5 2 5 2 5 2 5 2 5 2 5 2 5 2 5 2 5 3 5 2 5 2 5 2 5 2 5 2 5 4 5 4 5 2 5 2 5 2 5 2 5 2 5 2 3 0 3 0 3 0 3 0 3
4 5 4 5 4 5 1 5 2 5 2 5 2 5 2 5 2 5 2 5 3 5 3 5 3 5 3 5 2 5 3 5 3 5 2 5 2 5 2 5 2 5 2 5 2 5 2 5 2 5 2 5 2 5 2 5 2 5 3 5 3 5 3 5 3 5 2 5 2 5 2 5 2 5 2 5 4 5 4 5 2 5 2 5 2 5 2 5 2 5 2 5 2 5 2 5 0 3 0 3
4 5 4 5 1 5 1 5 2 5 2 5 2 5 2 5 2 5 2 5 3 5 3 5 3 5 3 5 2 5 2 5 3 5 2 5 2 5 2 5 2 5 2 5 2 5 2 5 2 5 2 5 2 5 2 5 3 5 3 5 2 5 3 5 3 5 2 5 2 5 2 5 1 5 1 5 4 5 4 5 1 5 2 5 2 5 2 5 2 5 2 5 2 5 2 5 2 5 0 3
4 5 2 5 1 5 1 5 2 5 2 5 2 5 2 5 2 5 2 5 2 5 2 5 3 5 3 5 2 5 2 5 3 5 2 5 2 5 2 5 2 5 2 5 2 5 2 5 2 5 2 5 2 5 2 5 3 5 3 5 3 5 3 5 3 5 2 5 2 5 2 5 1 5 1 5 4 5 4 5 1 5 1 5 2 5 2 5 2 5 2 5 2 5 2 5 2 5 0 3
2 5 2 5 2 5 2 5 2 5 2 5 2 5 2 5 2 5 2 5 2 5 2 5 3 5 3 5 2 5 2 5 2 5 2 5 2 5 2 5 2 5 2 5 2 5 2 5 2 5 2 5 2 5 2 5 3 5 3 5 3 5 3 5 2 5 2 5 2 5 2 5 2 5 1 5 4 5 4 5 1 5 2 5 2 5 2 5 2 5 2 5 2 5 2 5 2 5 0 3
2 5 2 5 2 5 2 5 2 5 2 5 2 5 2 5 2 5 2 5 2 5 2 5 2 5 2 5 2 5 2 5 2 5 2 5 2 5 2 5 2 5 2 5 2 5 2 5 2 5 2 5 2 5 2 5 2 5 2 5 2 5 3 5 2 5 2 5 2 5 2 5 2 5 2 5 4 5 4 5 2 5 2 5 2 5 2 5 2 5 2 5 2 5 2 5 2 5 0 3
2 5 2 5 2 5 2 5 2 5 2 5 2 5 2 5 2 5 2 5 2 5 2 5 2 5 2 5 2 5 2 5 2 5 2 5 2 5 2 5 2 5 2 5 2 5 2 5 2 5 2 5 2 5 2 5 2 5 2 5 2 5 2 5 2 5 2 5 2 5 2 5 2 5 2 5 4 5 4 5 2 5 2 5 2 5 2 5 2 5 2 5 2 5 2 5 2 5 0 3
